27
16
SSSSSSSSSSSSSSSSSSSSSSSSSSS
>.........................<
>.........................<
>.........................<
{h.......................h}
(H.T............T........H)
##########......###########
>f........................<
>.........................<
###......#########......###
>.........................<
>...g.................g...<
##########...P...##########
{h...F...................h}
(H..M........c........L..H)
###########################